XXXXXXXXXXXXXXXXXXXXXXXXXXXXXX
X                         X  X
X                         X  X
X  X  XXXX  X  X  XXXXXX  X  X
X  X     X                   X
X        X                   X
X     X  X  X  XXX  X  X  X  X
X  X                   X     X
X  X                   X     X
X  X  X  X  X  XXX  XXXX  X  X
X                         X  X
X                         X  X
X  X  X  X  XX  XX  X  X  X  X
X  X     X  X    X  X        X
X  X     X  X    X  X        X
X  X  X  X  XX  XX  X  X  X  X
X                      X     X
X                      X     X
X  XXXX  X  X  XXX  XXXX  X  X
X  X                         X
X  X                         X
X  X  X  XXXX  XXX  X  X  X  X
X                         X  X
X                         X  X
XXXX  XXX  XX  XXX  XXXXXXX  X
X                            X
X                            X
XXXXXXXXXXXXXXXXXXXXXXXXXXXXXX