Level1.txt
XXXXXXXXXXXXXXXXXXXXXXXXXXXXXX
X           E X            C X
X             X              X
X  XXXXXX  XXXXXX  XXXXXX  XXX
X  X                         X
X  X                         X
X  X  XXX    XXXX      XXXX  X
X                            X
X                            X
X  XXXXXXXX  XXXXXX  XXXX  XXX
X  X         X          X    X
X  X         X          X    X
X            X               X
X            XXXXXX          X
X    X                  X    X
X    X                  X    X
XXXXXXXX      X              X
X             X              X
X             X              X
X             X              X
X    XXXXXXX  XXXX  XXX  XXXXX
X    X                       X
X    X                       X
X                         X  X
XXXXXXXXX  XXXXXX         X  X
XC         X              XC X
X          X              X  X
XXXXXXXXXXXXXXXXXXXXXXXXXXXXXX